{
  "grid": [
    "A____AAAAARRRRRAAAAAAAAAATTTTA",
    "A____AAAAA______________A____A",
    "A_______________________A____A",
    "A____AAAA__________R____A____A",
    "A____________T_____R____A____A",
    "A____________T_____R_________A",
    "A____________T_____AAAAAAAAAAA",
    "ARRRRRRAAAAAAA_______________A",
    "T____________________________A",
    "T____________________________A",
    "T_____A______AAAAAAAAAAAAAAAAA",
    "T_____A______________________T",
    "A_____A______________________T",
    "A_____A______________________T",
    "A_____AAAAAAA________R_______T",
    "T_____A_____R________R_______A",
    "T_____A_____R________R_______A",
    "T_____A_____A________R_______A",
    "A___________A________R_______A",
    "A___________A________R_______A",
    "ATTTTTAAAAAAAAAAAAAAAAAA__G__A"
  
  ],
  "lights": {
    "count": 5,
    "type": "Point"
  }
}

